NO ./textures/north.png
SO ./textures/south.png
WE ./textures/west.png
EA ./textures/east.png
DO ./textures/door.png
F 220,100,0
C 225,30,0

1111111
100 001
100N001
1111111
