NO ./textures/wall/huge_1.png
EA ./textures/wall/huge_2.png
SO ./textures/wall/huge_3.png
WE ./textures/wall/huge_4.png
DO ./textures/door/door_2.png
C 20,90,120
F 0,125,80

1111111111111111111111111111111111111
1#1000#000110000000010#01    101#10#1
10#111d100000000000010001    10001011
101100010000000#000010#1111111d1#1001
10111d11000000000000d0000000000010001
1000#00000110000000011111111111111011
1100000000000000110000001000100000011
1111#111111111011100010010#011d11111
1100000011000101110000100000000011
100000000000000011100110#001000011
1000000000000000110000100001000011
1100000111010101100N00d00#0010#011
1111d111 1110101100000100001000001
11110111 1000100#00000110001100011111
1100011111d11110000111110011111111001
11#0000000001111111111111d00000011001
1111111111111          10011100000001
                       10#1 100000001
                       1111 111111111