NO ./textures/wall/fun_2.png
EA ./textures/wall/fun_1.png
SO ./textures/wall/fun_3.png
WE ./textures/wall/fun_4.png
DO ./textures/door/door-Fun.png

C 255,0,0
F 128,0,255

1111111111111111111111111
101000#000110000000010#01
1#0111d100000000000010001
100100010000000#000010#111111111
10111d11000000000000d000000000001
1000#0000011000000001111111111111
11000000000000001100000010001
1111#111111111011100010010#0111111
1100000011000101110000100000000011
100000000000000011100110#001000011
100000000000000011000100001000011
1100000111010101100N00d00#0010#011
1111d111 1110101100000100001000001
11110111 1000100#00000110001100011
1100011111d11110000111110011111111
11#0000000001111111111111d1111
1111111111111          1001
                       10#1
                       1111