NO ./textures/wall/Jungle_1.png
SO ./textures/wall/Jungle_2.png
WE ./textures/wall/Jungle_3.png
EA ./textures/wall/Jungle_4.png
DO ./textures/door/door_jungle.png
F 100,200,150
C 10,60,150

 1111111        111111111
110000011      10000000001
100000001     1000000000001
 100#001     100000000000001
  11011      1000000000000001
   101        1000000100000001
   1d1         100001 100000001
   101111111111100000100000001
   10d000000000d0000000000001
   1011111111111000000000001
   1d1         100000000001
   101        100000000001
  11011      100000000001
 1000001     1000000N0001
1000000#1     10000000001
110000011      1000000001
 1111111        111111111