NO ./textures/wall/arbre_1.png
SO ./textures/wall/2.png
WE ./textures/wall/4.png
EA ./textures/wall/3.png
DO ./textures/door/door_42_jungle.png
F 60,100,60
C 10,60,80

11111111111111111111111111111111
10000#0000000000#0110#0000001111
11111d11111000000000000000000001
1000000000010000#000011100001#11
11100000001000000000000000000001
1111100010111111#11111d11111d111
10000100001110000100000001000001
11011000000000111#00000111111101
10000000001111111d11000000010#01
1100#00N000000000100000000001111
10000000001100000011100000000001
11111111111111111111111111111111