NO ./textures/wall/wall.png
SO ./textures/wall/wall.png
WE ./textures/wall/wall.png
EA ./textures/wall/wall.png
DO ./textures/door/door_42_futur.png
F 100,200,150
C 10,60,80

111111111111111111111111111111111111111
1#101dd001d10ddd100000d0#0d1d10d1000101
100d1d0000dd010d1dd0d1dd0dd011110N0d001
10d0#0d00d1dd10001d000dd0d1d00110000101
1dd101dd0d1001100d1ddd1dddd100d11111101
1d111dd1d1111d1d0dd1d11111100d0d0#00001
101000dd1#11dd000000ddd10001d1111111111
1d1d0ddd0dd111111#d1d00dd1d00d00d0d1111
101dd0d1dd110d0001d1dd1d0d110111d0d1111
1dd0dd0d00dd01#10100d0d0000000d00dd0#01
111111111111111111111111111111111111111